UD_English-AAE-UD-v1	UD_English-EWT
UD_English-MoNoise	UD_English-EWT
UD_French-ExtremeUGC0.6.2	UD_French-GSD
UD_Frisian_Dutch-FAME	UD_Dutch-Alpino
UD_Akkadian-PISANDUB	UD_Estonian-EDT
UD_Akkadian-RIAO	UD_Estonian-EDT
UD_Akuntsu-TuDeT	UD_Czech-PDT
UD_Albanian-TSA	UD_Irish-IDT
UD_Amharic-ATT	UD_Estonian-EWT
UD_Apurina-UFPA	UD_Finnish-FTB
UD_Arabic-PUD	UD_Arabic-PADT
UD_Assyrian-AS	UD_Estonian-EWT
UD_Bambara-CRB	UD_Hindi_English-HIENCS
UD_Bhojpuri-BHTB	UD_Hindi-HDTB
UD_Breton-KEB	UD_French-GSD
UD_Cantonese-HK	UD_Chinese-GSD
UD_Chinese-CFL	UD_Chinese-GSDSimp
UD_Chinese-HK	UD_Chinese-GSD
UD_Chinese-PUD	UD_Chinese-GSD
UD_Chukchi-HSE	UD_Russian-SynTagRus
UD_Czech-PUD	UD_Czech-PDT
UD_English-PUD	UD_English-EWT
UD_English-Pronouns	UD_English-EWT
UD_Erzya-JR	UD_Belarusian-HSE
UD_Faroese-OFT	UD_Faroese-FarPaHC
UD_Finnish-OOD	UD_Finnish-TDT
UD_Finnish-PUD	UD_Finnish-TDT
UD_French-FQB	UD_French-GSD
UD_French-PUD	UD_French-GSD
UD_German-LIT	UD_German-HDT
UD_German-PUD	UD_German-HDT
UD_Hindi-PUD	UD_Hindi-HDTB
UD_Icelandic-PUD	UD_Icelandic-IcePaHC
UD_Indonesian-PUD	UD_Indonesian-GSD
UD_Italian-PUD	UD_Italian-ISDT
UD_Japanese-Modern	UD_Japanese-GSD
UD_Japanese-PUD	UD_Japanese-GSD
UD_Karelian-KKPP	UD_Finnish-TDT
UD_Khunsari-AHA	UD_Persian-PerDT
UD_Komi_Permyak-UH	UD_Russian-SynTagRus
UD_Komi_Zyrian-IKDP	UD_Russian-SynTagRus
UD_Komi_Zyrian-Lattice	UD_Russian-SynTagRus
UD_Korean-PUD	UD_Korean-Kaist
UD_Manx-Cadhan	UD_Singlish-SingPar
UD_Mbya_Guarani-Thomas	UD_Italian-ISDT
UD_Moksha-JR	UD_Russian-SynTagRus
UD_Munduruku-TuDeT	UD_Romanian-Nonstandard
UD_Nayini-AHA	UD_Persian-PerDT
UD_Old_Turkish-Tonqq	UD_Estonian-EWT
UD_Polish-PUD	UD_Polish-PDB
UD_Portuguese-PUD	UD_Portuguese-GSD
UD_Russian-PUD	UD_Russian-SynTagRus
UD_Sanskrit-UFAL	UD_Hindi-HDTB
UD_Skolt_Sami-Giellagas	UD_Indonesian-GSD
UD_Soi-AHA	UD_Persian-PerDT
UD_South_Levantine_Arabic-MADAR	UD_Arabic-PADT
UD_Spanish-PUD	UD_Spanish-GSD
UD_Swedish-PUD	UD_Swedish-LinES
UD_Swiss_German-UZH	UD_German-HDT
UD_Tagalog-TRG	UD_Singlish-SingPar
UD_Tagalog-Ugnayan	UD_Singlish-SingPar
UD_Tamil-MWTT	UD_Tamil-TTB
UD_Thai-PUD	UD_English-EWT
UD_Tupinamba-TuDeT	UD_Czech-PDT
UD_Turkish-GB	UD_Turkish-BOUN
UD_Turkish-PUD	UD_Turkish-BOUN
UD_Warlpiri-UFAL	UD_Indonesian-GSD
UD_Yoruba-YTB	UD_Irish-IDT
